FFFFFFFFFFFFFFFFFFFFFFFFFFFFFFFFFFF
0000F000F000F0000000F000F000F000F00
FFF0F0F0F0F0F0F0F0F0F0F0F0F0F0F0F0F
F0F0F0F000F0F0F0F000F0F0F0F000F0F0F
F0F0F0F0F0F0F0F0F0F0F0F0F0F0F0F0F0F
F0F0F0F0F0F0F0F0F0F0F0F0F0F0F0F0F0F
F0F0F0F0F0F0F0F0F0F0F0F0F0F0F0F0F0F
F0F0F0F0F0F0F0F0F0F0F0F0F0F0F0F0F0F
F0F0F0F0F0F0F0F0F0F0F0F0F0F0F0F0F0F
F0F000F000F000F000F000F000F000F000F
F0F0F00FF0FFFFFFFFF0FFFFFFFFFFFFFFF
0000F000F000F0000000F000F000F000F00
FFF0F0F0F0F0F0F0F0F0F0F0F0F0F0F0F0F
F0F0F0F000F0F0F0F000F0F0F0F000F0F0F
F0F0F0F0F0F0F0F0F0F0F0F0F0F0F0F0F0F
F0F0F0F0F0F0F0F0F0F0F0F0F0F0F0F0F0F
F0F0F0F0F0F0F0F0F0F0F0F0F0F0F0F0F0F
F0F0F0F0F0F0F0F0F0F0F0F0F0F0F0F0F0F
F0F0F0F0F0F0F0F0F0F0F0F0F0F0F0F0F0F
F0F000F000F000F000F000F000F000F000F
FFFFFFFFFFFFFFFFFFFFFFFFFFFFFFFFFFF
0,1
34,1